6 10 9 3 0 5 4
5 4 2 1 2 6
2 4 4 4 4 5
5 4 4 0 0 1
3 5 0 5 5 1
3 5 1 5 2 1
0 5 2 5 0 0
0 5 3 5 0 2
5 5 3 0 0 2
5 5 4 0 0 0
5 2 2 6 0 5
