Easy level: 1
2 1 6 3 2 3
2 3 2 4 3 0
3 3 2 2 3 3
0 0 0 0 2 3
2 0 0 0 4 0
4 2 0 2 4 0
2 1 2 2 2 2
1 3 1 3 2 4
4 4 2 1 1 3
4 0 5 4 1 3
Minimum move: 6

